*********
+**+**+*+
*++*++*+*
****+****
****0****
***+**++*
**+*++**+